EEEEEEEEEEEEEEEEEEEEEEEEEEEEEEEEEEE
E3AAAAAEEEEAAA0AAAEEE5AAAAAAAAAAAAE
EEEAEAAAAEEEFEEEEAEEEEEEEAEEEEEAAAE
EEEAEEAAAAEEEEEEAAEEEEEEEFEEEEEEAWE
EEWWEEEEAAAAAAAAAAAAAAAAAAAEEEEEEWE
EAWEEEEEEEEEEEEEFEEFEFEFEEWEEEEEEWE
EAEEAEEEEEEEEEEFFFEEEEEEEEWEEEEEEWE
EAA1AAEEEEEEEFFFEEEEEEEEEEWWWWWWEWE
EAEEAAAAAFFFFFEEEEAAEEEEEWWWWWWWEWE
EAEEEWEEEEEEEEE2AAAAAAWWWWWWWWWWEWE
EAEEEWWWWEEEEEEEEEFFFFEEEEEWWWWWEWE
EAEEWWWWEEEEEEEEEEEEEEEEEEEEWWWWWWE
EAEEWWWEEEEEEEEEEEEEEEEEEEEEEEEEEEE
EAEEEWEEEEEEEEEEEEEEEEEEEEEEEEEEEEE
EAEEEAEEEEEEEEEEEEEEAAAAAAEEEEEEEEE
EAAEAAAAAAEEEEEEEAAAAAAAAAAAAAAEEEE
EAAAAAAAAAEEEEEEAAAEAEAEAEEAA4AAAEE
EEEEEEEEAAAEEAAAAAEEAEAEAEEEEEEEEEE
EEEEEEEEEAAAEAAAAEEEAEAEAEFFFFFFFFE
EEEEEEEEEEAAAAAAEEEEFFFFFFFFFFFEEEE
EEEEEEEEEEEEEEEEEEEEEEEEEEEEEEEEEEE